//MAP CONVERTED BY dmm2tgm.py THIS HEADER COMMENT PREVENTS RECONVERSION, DO NOT REMOVE
"aaa" = (
/turf/open/space/basic,
/area/space)
"afY" = (
/obj/effect/landmark/start/new_player,
/turf/open/floor/plating,
/area/start)
"agu" = (
/turf/closed/indestructible/splashscreen,
/area/start)
"aCl" = (
/turf/closed/indestructible/start_area,
/area/start)

(1,1,1) = {"
aaa
aaa
aaa
aaa
aaa
aaa
aaa
aaa
aaa
aaa
aaa
aCl
aCl
aCl
aCl
aCl
aCl
aCl
aCl
aCl
aCl
aCl
aCl
aCl
aCl
agu
"}
(2,1,1) = {"
aaa
aaa
aaa
aaa
aaa
aaa
aaa
aaa
aaa
aaa
aaa
aCl
aCl
aCl
aCl
aCl
aCl
aCl
aCl
aCl
aCl
aCl
aCl
aCl
aCl
aCl
"}
(3,1,1) = {"
aaa
aaa
aaa
aaa
aaa
aaa
aaa
aaa
aaa
aaa
aaa
aCl
aCl
aCl
aCl
aCl
aCl
aCl
aCl
aCl
aCl
aCl
aCl
aCl
aCl
aCl
"}
(4,1,1) = {"
aaa
aaa
aaa
aaa
aaa
aaa
aaa
aaa
aaa
aaa
aaa
aCl
aCl
aCl
aCl
aCl
aCl
aCl
aCl
aCl
aCl
aCl
aCl
aCl
aCl
aCl
"}
(5,1,1) = {"
aaa
aaa
aaa
aaa
aaa
aaa
aaa
aaa
aaa
aaa
aaa
aCl
aCl
aCl
aCl
aCl
aCl
aCl
aCl
aCl
aCl
aCl
aCl
aCl
aCl
aCl
"}
(6,1,1) = {"
aaa
aaa
aaa
aaa
aaa
aaa
aaa
aaa
aaa
aaa
aaa
aCl
aCl
aCl
aCl
aCl
aCl
aCl
aCl
aCl
aCl
aCl
aCl
aCl
aCl
aCl
"}
(7,1,1) = {"
aaa
aaa
aaa
aaa
aaa
aaa
aaa
aaa
aaa
aaa
aaa
aCl
aCl
aCl
aCl
aCl
aCl
aCl
aCl
aCl
aCl
aCl
aCl
aCl
aCl
aCl
"}
(8,1,1) = {"
aaa
aaa
aaa
aaa
aaa
aaa
aaa
aaa
aaa
aaa
aaa
aCl
aCl
aCl
aCl
aCl
aCl
aCl
aCl
aCl
aCl
aCl
aCl
aCl
aCl
aCl
"}
(9,1,1) = {"
aaa
aaa
aaa
aaa
aaa
aaa
aaa
aaa
aaa
aaa
aaa
aCl
aCl
aCl
aCl
aCl
aCl
aCl
aCl
aCl
aCl
aCl
aCl
aCl
aCl
aCl
"}
(10,1,1) = {"
aaa
aaa
aaa
aaa
aaa
aaa
aaa
aaa
aaa
aaa
aaa
aCl
aCl
aCl
aCl
aCl
aCl
aCl
aCl
aCl
aCl
aCl
aCl
aCl
aCl
aCl
"}
(11,1,1) = {"
aaa
aaa
aaa
aaa
aaa
aaa
aaa
aaa
aaa
aaa
aaa
aCl
aCl
aCl
aCl
aCl
aCl
aCl
afY
aCl
aCl
aCl
aCl
aCl
aCl
aCl
"}
(12,1,1) = {"
aaa
aaa
aaa
aaa
aaa
aaa
aaa
aaa
aaa
aaa
aaa
aCl
aCl
aCl
aCl
aCl
aCl
aCl
aCl
aCl
aCl
aCl
aCl
aCl
aCl
aCl
"}
(13,1,1) = {"
aaa
aaa
aaa
aaa
aaa
aaa
aaa
aaa
aaa
aaa
aaa
aCl
aCl
aCl
aCl
aCl
aCl
aCl
aCl
aCl
aCl
aCl
aCl
aCl
aCl
aCl
"}
(14,1,1) = {"
aaa
aaa
aaa
aaa
aaa
aaa
aaa
aaa
aaa
aaa
aaa
aCl
aCl
aCl
aCl
aCl
aCl
aCl
aCl
aCl
aCl
aCl
aCl
aCl
aCl
aCl
"}
(15,1,1) = {"
aaa
aaa
aaa
aaa
aaa
aaa
aaa
aaa
aaa
aaa
aaa
aCl
aCl
aCl
aCl
aCl
aCl
aCl
aCl
aCl
aCl
aCl
aCl
aCl
aCl
aCl
"}
(16,1,1) = {"
aaa
aaa
aaa
aaa
aaa
aaa
aaa
aaa
aaa
aaa
aaa
aCl
aCl
aCl
aCl
aCl
aCl
aCl
aCl
aCl
aCl
aCl
aCl
aCl
aCl
aCl
"}
(17,1,1) = {"
aaa
aaa
aaa
aaa
aaa
aaa
aaa
aaa
aaa
aaa
aaa
aCl
aCl
aCl
aCl
aCl
aCl
aCl
aCl
aCl
aCl
aCl
aCl
aCl
aCl
aCl
"}
(18,1,1) = {"
aaa
aaa
aaa
aaa
aaa
aaa
aaa
aaa
aaa
aaa
aaa
aCl
aCl
aCl
aCl
aCl
aCl
aCl
aCl
aCl
aCl
aCl
aCl
aCl
aCl
aCl
"}
(19,1,1) = {"
aaa
aaa
aaa
aaa
aaa
aaa
aaa
aaa
aaa
aaa
aaa
aCl
aCl
aCl
aCl
aCl
aCl
aCl
aCl
aCl
aCl
aCl
aCl
aCl
aCl
aCl
"}
(20,1,1) = {"
aaa
aaa
aaa
aaa
aaa
aaa
aaa
aaa
aaa
aaa
aaa
aCl
aCl
aCl
aCl
aCl
aCl
aCl
aCl
aCl
aCl
aCl
aCl
aCl
aCl
aCl
"}
(21,1,1) = {"
aaa
aaa
aaa
aaa
aaa
aaa
aaa
aaa
aaa
aaa
aaa
aCl
aCl
aCl
aCl
aCl
aCl
aCl
aCl
aCl
aCl
aCl
aCl
aCl
aCl
aCl
"}
(22,1,1) = {"
aaa
aaa
aaa
aaa
aaa
aaa
aaa
aaa
aaa
aaa
aaa
aCl
aCl
aCl
aCl
aCl
aCl
aCl
aCl
aCl
aCl
aCl
aCl
aCl
aCl
aCl
"}
